{
  "name": "Arena 2",
  "description": "Large arena with pillars",
  "width": 20,
  "height": 16,
  "grid": [
    "####################",
    "#                  #",
    "#  E    ##  ##   E #",
    "#      ##  ##      #",
    "#   ##    ##   ##  #",
    "#   ##    ##   ##  #",
    "#      ##  ##      #",
    "#  P   ##  ##      #",
    "#      ##  ##      #",
    "#   ##    ##   ##  #",
    "#   ##    ##   ##  #",
    "#      ##  ##      #",
    "#  E   ##  ##   E  #",
    "#      ##  ##      #",
    "#                  #",
    "####################"
  ]
}
