{
  "name": "Arena",
  "description": "Open combat arena",
  "width": 16,
  "height": 16,
  "grid": [
    "################",
    "#              #",
    "#  E   E   E  #",
    "#              #",
    "#    #####     #",
    "#    # P #     #",
    "#    #####     #",
    "#              #",
    "#    #####     #",
    "#    #   #     #",
    "#    #####     #",
    "#              #",
    "#  E   E   E  #",
    "#              #",
    "#              #",
    "################"
  ]
}
