{
  "name": "Labyrinth",
  "description": "Complex 30x30 maze with multiple paths and many enemies",
  "width": 30,
  "height": 30,
  "grid": [
    "##############################",
    "#P  E  s      #       D    E #",
    "#  #######  ## # ######## ## #",
    "#  #       ##  # #      # ## #",
    "#  # ##### ##  # # #### # ## #",
    "#  # #   # ##  # # #  # # ## #",
    "# E# # # # ##  # # #  # # ## #",
    "#  # # # # ##  # # #  # # ## #",
    "#  # # # # ##  # # #  # # ## #",
    "#  # # ### ##  # # #  #### ## #",
    "# S# #     ##  # # #      # ## #",
    "#  # #######  # # # ###### # ##",
    "# D#          # # #        # ##",
    "#  ########## # # ########## ##",
    "# S           # #            ##",
    "############ # # ############ #",
    "#          # # # #          # #",
    "# ######## # # # # ######## # #",
    "# #      # # # # # #      # # #",
    "# # #### # # # # # # #### # # #",
    "# # #  # # # # # # # #  # # # #",
    "# # #  # # # # # # # #  # # # #",
    "# # ### # # # # # # # #### # # #",
    "# #     # # # # # # #      # # #",
    "# ####### # # # # ########## # #",
    "#    E    # # # #            # #",
    "######### # # ###########D### #",
    "#E      D# # # S          D  #",
    "# ########## # ######E####### #",
    "#          F        E          #",
    "##############################"
  ],
  "goal": {"x": 27.5, "y": 28.5},
  "items": [
    {"x": 5.5, "y": 5.5, "type": "health_pack", "value": 25},
    {"x": 24.5, "y": 5.5, "type": "armor_light", "value": 50},
    {"x": 5.5, "y": 24.5, "type": "armor_heavy", "value": 100},
    {"x": 24.5, "y": 24.5, "type": "health_pack", "value": 25},
    {"x": 14.5, "y": 14.5, "type": "ammo_shotgun", "value": 10},
    {"x": 8.5, "y": 18.5, "type": "health_pack", "value": 25},
    {"x": 21.5, "y": 8.5, "type": "armor_light", "value": 50},
    {"x": 12.5, "y": 25.5, "type": "health_pack", "value": 25}
  ]
}