{
  "name": "Maze",
  "description": "Complex maze layout",
  "width": 20,
  "height": 20,
  "grid": [
    "####################",
    "#P                 #",
    "# ####### ### ###  #",
    "# #     # #   #    #",
    "# # ### # # # # ## #",
    "# # #   # # # #    #",
    "# # # # # # # ## ## #",
    "# # # # # # #      #",
    "# # # # # # ###### #",
    "#   # # #         #",
    "##### # ########## #",
    "#     #          # #",
    "# ############## # #",
    "#              # # #",
    "####### ##### # # #",
    "#       #   # # # #",
    "# ####### # # # # #",
    "# #       #   # # #",
    "# # ##### ##### # #",
    "# E            E  #",
    "####################"
  ]
}
