{
  "name": "Mission Impossible",
  "description": "Large 32x32 mission map with start at one corner and goal at opposite corner",
  "width": 32,
  "height": 32,
  "grid": [
    "################################",
    "#P                             #",
    "# ###### ########## ###### ### #",
    "# #    # #      #  #    # #   #",
    "# # E  # #  E   #  # E  # #   #",
    "# #    # #      #  #    # # D #",
    "###### # ######### ###### ### #",
    "#      #                E     #",
    "# #### # ############# ### ### #",
    "# #  # # #         # #   #   #",
    "# #  # # # # ##### # # E # E #",
    "# #  # # # # #   # # #   #   #",
    "# #### # # # # E # # ##### ### #",
    "#      # # #     # #         #",
    "######## # ######### ##### ### #",
    "#        #         # #   #   #",
    "# ###### # ##### # # # E # E #",
    "# #    # # #   # # # #   #   #",
    "# # E  # # # E # # # ##### ### #",
    "# #    # # #   # # #       D   #",
    "###### # # ### # # ######### ###",
    "#      # #   # # #           #",
    "# ###### ### # # ########### #",
    "# #    #   # # #           # #",
    "# # E  # # # # ######### # # #",
    "# #    # # # # #       # # # #",
    "# ###### # # # # # E   # # # #",
    "#        # # # # #     # # # #",
    "########## # # # ##### # # # #",
    "#          # # #       # # # #",
    "# ########## # ####### # # # #",
    "#                              #"
  ],
  "goal": {"x": 28.5, "y": 30.5},
  "items": [
    {"x": 5.5, "y": 5.5, "type": "health_pack", "value": 25},
    {"x": 26.5, "y": 3.5, "type": "armor_light", "value": 50},
    {"x": 3.5, "y": 18.5, "type": "armor_heavy", "value": 100},
    {"x": 20.5, "y": 12.5, "type": "health_pack", "value": 25},
    {"x": 10.5, "y": 22.5, "type": "ammo_shotgun", "value": 10},
    {"x": 28.5, "y": 18.5, "type": "armor_light", "value": 50},
    {"x": 15.5, "y": 28.5, "type": "health_pack", "value": 25},
    {"x": 8.5, "y": 29.5, "type": "armor_heavy", "value": 100}
  ]
}