{
  "name": "Mission",
  "description": "A large 24x24 mission map with enemies, items, and a goal",
  "width": 24,
  "height": 24,
  "grid": [
    "########################",
    "#                      #",
    "#  #######  #######    #",
    "#  #     #  #     #    #",
    "#  #  P  #  #     #    #",
    "#  #     #  #     #    #",
    "#  #######  #######    #",
    "#          #######     #",
    "#    E     #     #  E  #",
    "#          #     #     #",
    "#######    #     #######",
    "#     #    #            #",
    "#     #    #     #######",
    "#  E  #    #     #     #",
    "#     #    #     #     #",
    "#######    #######     #",
    "#          #######     #",
    "#     #  E #     #     #",
    "#     #    #     #     #",
    "#######    #######     #",
    "#         #######      #",
    "#    E    #     #   E  #",
    "#         #  F  #      #",
    "########################"
  ],
  "goal": [19.5, 21.5],
  "items": [
    { "x": 3.5, "y": 5.5, "type": "health_pack", "value": 25 },
    { "x": 10.5, "y": 3.5, "type": "armor_light", "value": 25 },
    { "x": 17.5, "y": 7.5, "type": "health_pack", "value": 25 },
    { "x": 5.5, "y": 17.5, "type": "armor_heavy", "value": 50 },
    { "x": 17.5, "y": 15.5, "type": "ammo_shotgun", "value": 10 },
    { "x": 10.5, "y": 21.5, "type": "health_pack", "value": 25 }
  ]
}