{
  "grid": [
    "################",
    "#              #",
    "#   E    #     #",
    "#        #     #",
    "#      ###     #",
    "#      # P     #",
    "#          E   #",
    "#    ###       #",
    "#    #         #",
    "#    #    #    #",
    "#        #     #",
    "#   ###        #",
    "#          E   #",
    "#              #",
    "#              #",
    "################"
  ],
  "width": 16,
  "height": 16
}
